receive	get	synonym
seems	appears	synonym
like	wish	synonym
achieved	reached	synonym
fundamental	key	synonym
excellent	splendid	synonym
amount	quantity	synonym
essential	crucial	synonym
good	sound	synonym
particularly	especially	synonym
win	gain	synonym
means	implies	synonym
good	sound	synonym
believed	thought	synonym
central	key	synonym
result	outcome	synonym
offer	provide	synonym
financial	fiscal	synonym
programmes	programs	synonym
world	globe	synonym
behaviour	behavior	synonym
think	believe	synonym
case	event	synonym
crude	rough	synonym
lead	go	synonym
issues	matters	synonym
want	wish	synonym
appoint	nominate	synonym
sums	amounts	synonym
forward	ahead	synonym
absence	Without	paraphrase
amount	figure	paraphrase
better	preferable	paraphrase
restore	rehabilitate	paraphrase
wrong	mistaken	paraphrase
dream	sleep	paraphrase
past	last	paraphrase
final	ultimate	paraphrase
way	road	paraphrase
distribution	allocation	paraphrase
strengthened	reinforced	paraphrase
main	major	paraphrase
strengthen	boost	paraphrase
essential	vital	paraphrase
Major	huge	paraphrase
last	recent	paraphrase
joint	concerted	paraphrase
practical	tangible	paraphrase
broad	large	paraphrase
first	initial	paraphrase
larger	greater	paraphrase
existing	current	paraphrase
field	sector	paraphrase
work	job	paraphrase
major	large	paraphrase
condemn	denounce	paraphrase
excellent	good	paraphrase
work	job	paraphrase
clear	straightforward	paraphrase
internal	domestic	paraphrase
drawn	devised	related
flare-up	eruption	related
capital	stock	related
EU	US	related
given	signalled	related
remains	endures	related
dispute	debate	related
EU	US	related
interested	key	related
States	America	related
improve	sharpen	related
made	advanced	related
Minister	Chancellor	related
found	transpired	related
return	come	related
side	end	related
officials	placemen	related
happen	become	related
freeze	hold	related
say	involved	related
development	reform	related
state	proclaimed	related
way	health	related
have	be	related
was	has	related
corrected	marked	related
wind	end	related
an	s	related
trials	Cases	related
has	is	related
next	coming	none
coming	next	none
done	made	none
reduced	small	none
absent	missing	none
welcome	gratifying	none
fight	combating	none
fight	combating	none
compulsory	binding	none
unclear	blurred	none
fight	combating	none
outraged	angry	none
widespread	generalized	none
dominant	dominating	stem
preventive	preventative	stem
first	firstly	stem
States	State	stem
continued	continuing	stem
ageing	aging	stem
Third	Thirdly	stem
understand	understanding	stem
particular	particularly	stem
clear	clearly	stem
reliable	reliably	stem
selecting	selection	stem
discuss	discussions	stem
poison	poisoning	stem
its	it	stem
effective	effectively	stem
credible	credibly	stem
kill	killing	stem
Iranians	Iranian	stem
transition	transitional	stem
cooperation	cooperative	stem
its	it	stem
European	Europeans	stem
surprising	surprisingly	stem
intuition	intuitive	stem
famous	famously	stem
weak	weakness	stem
domination	dominance	stem